Abundance  : A very large quantity of something.
Ad Infinitum  : Again and again in the same way; forever
Admirable  : Arousing or deserving respect and approval.
Adoration  : Deep love and respect.
Affable  : Friendly, good-natured, or easy to talk to.
Agility  : Ability to move or think quickly and easily.
Agastopia : An admiration for a particular part of someone’s body - usage - rare
Ailurophile  : A cat lover.
Alacrity  : Brisk and cheerful readiness.
Alluring  : Powerfully and mysteriously attractive or fascinating; seductive.
Aloha  : A Hawaiian word used when greeting or parting from someone.
Altruism  : The belief in or practise of disinterested and selfless concern for the well-being of others.
Amaranthine  : From the Greek word amarantos, meaning immortal or unfading.
Amiable  : Having or displaying a friendly and pleasant manner.
Amorous  : Showing, feeling, or relating to sexual desire.
Amorphous : Without a clearly defined shape or form
Angelic  : An exceptionally beautiful, innocent, or kind person.
Apotheosis  : The highest point in the development of something; culmination or climax.
Assemblage  : A collection or gathering of things or people.
Astonishing  : Extremely surprising or impressive; amazing.
Astounding  : Surprisingly impressive or notable.
Ascension  : The act of rising to an important position or a higher level.
Astral  : Of, connected with or resembling the stars.
Audacious  : Showing a willingness to take surprisingly bold risks.
Aurora  : A natural electrical phenomenon characterized by the appearance of streamers of reddish or greenish light in the sky, usually near the northern or southern magnetic pole.
Awe  : A feeling of reverential respect mixed with fear or wonder.
Beatify  : To make holy or sacred.
Beauteous  : Beautiful.
Becoming  : Flattering a person's appearance.
Beguile  : To charm or enchant (someone), sometimes in a deceptive way.
Belonging  : An affinity for a place or situation.
Beloved  : Dearly loved.
Benefactor  : A person who gives money or other help to a person or cause.
Benevolence  : The quality of being well meaning; kindness.
Blazing  : To burn fiercely or brightly.
Blessing  : A beneficial thing for which one is grateful; something that brings well-being.
Bliss  : Perfect happiness; great joy.
Blossom  : The state or period of flowering.
Breathtaking  : Astonishing or awe-inspiring in quality, so as to take one's breath away.
Breeziness  : Fresh and animated; lively.
Brilliance  : An intense brightness of light.
Brisk  : Active, fast, and energetic.
Bubbling  : Characterized by cheerful high spirits.
Bucolic  : Relating to the pleasant aspects of the countryside and country life.
Bungalow  : A low house, with a broad front porch, having either no upper floor or upper rooms set in the roof, typically with dormer windows.
Buoyancy  : The ability or tendency to float in water or air or some other fluid.
Cadence : A modulation or inflection of the voice
Calcination  : To heat (a substance) to a high temperature but below the melting or fusing point, causing loss of moisture, reduction or oxidation, and the decomposition of carbonates and other compounds.
Calm  : Not showing or feeling nervousness, anger, or other strong emotions.
Candor  : The quality of being open and honest in expression; frankness.
Caprice  : A sudden and unaccountable change of mood or behaviour.
Carpe Diem  : Latin, ‘seize the day!’, a quotation from Horace.
Cascade  : A small waterfall, typically one of several that fall in stages down a steep rocky slope.
Cashmere  : Fine, soft wool, originally that from the Kashmir goat.
Catharsis  : The process of releasing, and thereby providing relief from, strong or repressed emotions.
Celerity  : The swiftness of movement.
Centered  : Well balanced and confident or serene.
Champion  : A person who fights or argues for a cause or on behalf of someone else.
Charisma  : Compelling attractiveness or charm that can inspire devotion in others.
Charm  : The power or quality of giving delight or arousing admiration.
Chatoyant  : Of a gem, especially when cut en cabochon, showing a band of bright reflected light caused by aligned inclusions in the stone.
Cheerful  : Noticeably happy and optimistic.
Chrysalis  : A transitional state.
Chromophobia:  An irrational fear of colours.
Cinnamon  : An aromatic spice made from the peeled, dried and rolled bark of a Southeast Asian tree.
Clarity  : The quality of being coherent and intelligible.
Classy  : Stylish and sophisticated.
Clearheaded  : Alert and thinking logically and coherently.
Clinomania  : An obsession with bed rest.
Coalesce  : Come together to form one mass or whole.
Comely  : Typically a woman who is pleasant to look at; attractive.
Compassion  : Sympathetic pity and concern for the sufferings or misfortunes of others.
Conflate  : Combine (two or more texts, ideas, etc.) into one.
Consciousness  : The state of being awake and aware of one's surroundings.
Contentment  : A state of happiness and satisfaction.
Coruscate  : Flash or sparkle of light.
Creativity  : The use of the imagination or original ideas, especially in the production of artistic work.
Crepuscular  : Of, resembling, or relating to twilight.
Crystalline  : Having the structure and form of a crystal; composed of crystals.
Cuddle  : Hold close in one's arms as a way of showing love or affection.
Cynosure  : A person or thing that is the centre of attention or admiration.
Cynefin : a Welsh word, which is commonly translated into English as `habitat` or `place`, but it means where a person or animal feels it belongs. The place where you feel most at home and welcomed.
Dalliance  : A casual romantic or sexual relationship.
Dandy  : A man unduly devoted to style, neatness, and fashion in dress and appearance.
Dapper  : Typically a man who is neat and trim in dress, appearance, or bearing.
Dauntless  : Showing fearlessness and determination.
Dazzling  : Extremely bright, especially so as to blind the eyes temporarily.
Debonair  : A man who is confident, stylish, and charming.
Delicate  : Very fine in texture or structure; of intricate workmanship or quality.
Delicious  : Highly pleasant to the taste.
Delightful  : Causing delight; charming.
Demesne  : Land attached to a manor and retained for the owner's own use.
Demure  : A woman who is reserved, modest, and shy.
Denouement  : The final part of a play, movie, or narrative in which the strands of the plot are drawn together and matters are explained or resolved.
Desirable  : Wanted or wished for as being an attractive, useful, or necessary course of action.
Desiderium : An ardent desire or longing especially, a feeling of loss or grief for something lost.
Desuetude  : A state of disuse.
Desultory  : Lacking a plan, purpose, or enthusiasm.
Devotion  : Love, loyalty, or enthusiasm for a person, activity, or cause.
Diaphanous  : Light, delicate, and translucent, especially a fabric.
Discombobulate  : To disconcert or confuse someone.
Dissemble  : To conceal one's true motives, feelings, or beliefs.
Divinity  : The state or quality of being divine.
Doting  : Extremely and uncritically fond of someone; adoring.
Dreamy  : Having a magical or pleasantly unreal quality; dreamlike.
Dulcet  : A sweet and soothing sound.
Earnest  : Resulting from or showing sincere and intense conviction
Ebullience  : The quality of being cheerful and full of energy; exuberance.
Ecstasy  : An overwhelming feeling of great happiness or joyful excitement.
Effervescent  : A liquid giving off bubbles; fizzy.
Efflorescence  : A state or time of flowering.
Effortless  : Requiring no physical or mental exertion.
Elation  : Great happiness and exhilaration.
Elegant  : Pleasingly graceful and stylish in appearance or manner.
Elision  : The omission of a sound or syllable when speaking
Elixir  : A magical or medicinal potion.
Eloquence  : Fluent or persuasive speaking or writing.
Embrocation  : A liquid used for rubbing on the body to relieve pain from sprains and strains.
Emollient  : Having the quality of softening or soothing the skin.
Emulate  : Match or surpass (a person or achievement), typically by imitation.
Enamoured  : To be filled with a feeling of love for someone or something.
Enchanted  : Placed under a spell; bewitched.
Enraptured  : Experiencing intense pleasure or joy.
Enthralled  : Experiencing fascinated attention.
Ephemeral  : Lasting for a very short time.
Epiphany  : A moment of sudden revelation or insight.
Equanimity  : Mental calmness, composure, and evenness of temper, especially in a difficult situation.
Equilibrium  : A state in which opposing forces or influences are balanced.
Erstwhile  : Former.
Ethereal  : Extremely delicate and light in a way that seems too perfect for this world.
Etiquette  : The customary code of polite behaviour in society or among members of a particular profession or group.
Euphoria  : A feeling or state of intense excitement and happiness.
Evanescent  : Soon passing out of sight, memory, or existence; quickly fading or disappearing.
Evocative  : Bringing strong images, memories, or feelings to mind.
Exonerate  : To absolve someone from blame for a fault or wrongdoing, especially after due consideration of the case.
Exquisite  : Extremely beautiful and, typically, delicate.
Exuberant  : Filled with or characterized by a lively energy and excitement.
Fabulous  : Amazingly good; wonderful.
Faithful  : Loyal, constant, and steadfast.
Fascination  : The power to fascinate someone; the quality of being fascinating.
Feasible  : Possible to do easily or conveniently.
Feisty  : A person who is relatively small or weak but also lively, determined, and courageous.
Felicity  : Intense happiness.
Festive  : Cheerful and jovially celebratory.
Fetching  : Attractive.
Fidelity  : Faithfulness to a person, cause, or belief, demonstrated by continuing loyalty and support.
Filament  : A slender threadlike object or fibre, especially one found in animal or plant structures.
Flawless  : Without any blemishes or imperfections; perfect.
Flourish  : To grow or develop in a healthy or vigorous way, especially as the result of a particularly favourable environment.
Flowing  : Hanging or draping loosely and gracefully.
Forbearance  : Patient self-control; restraint and tolerance.
Fortitude  : Courage in pain or adversity.
Friendship  : The emotions or conduct of friends; the state of being friends.
Fugacious  : Tending to disappear; fleeting.
Fulfilling  : Making someone satisfied or happy because of fully developing their character or abilities.
Furtive  : Attempting to avoid notice or attention, typically because of guilt or a belief that discovery would lead to trouble; secretive.
Gambol  : Run or jump about playfully.
Gargantuan  : Enormous.
Giddy  : Having a sensation of whirling and a tendency to fall or stagger; dizzy.
Ginger  : A hot, fragrant spice made from the rhizome of a plant, which may be chopped or powdered for cooking, preserved in syrup, or candied.
Glamour  : An attractive or exciting quality that makes certain people or things seem appealing.
Glorious  : Having a striking beauty or splendor that evokes feelings of delighted admiration.
Goddess  : A woman who is adored, especially for her beauty.
Gorgeous  : Beautiful; very attractive.
Gossamer  : Used to refer to something very light, thin, and insubstantial or delicate.
Graceful  : Having or showing grace or elegance.
Halcyon  : Denoting a period of time in the past that was idyllically happy and peaceful.
Handsome  : A good-looking man.
Harbinger  : A forerunner of something.
Harmony  : The quality of forming a pleasing and consistent whole.
Heartfelt  : A feeling or its expression that is sincere; deeply and strongly felt.
Heartwarming  : Emotionally rewarding or uplifting.
Heavenly  : Very pleasing; wonderful.
Hilarity  : Extreme amusement, especially when expressed by laughter.
Holiness  : The state of being holy.
Hopefulness  : Having or manifesting hope.
Humility  : A modest or low view of ones own importance; humbleness.
Idyllic  : A time or place that is extremely happy, peaceful, or picturesque.
Illumination  : Lighting or light.
Illustrious  : Well known, respected, and admired for past achievements.
Imbrication  : An overlapping of edges (as of tiles or scales).
Imbroglio  : An extremely confused, complicated, or embarrassing situation.
Imbue  : To inspire or permeate with a feeling or quality.
Incandescence  : The light emmited by an incandescent object.
Incipient  : In an initial stage; beginning to happen or develop.
Ineffable  : Too great or extreme to be expressed or described in words.
Ingenue  : An innocent or unsophisticated young woman, especially in a play or film.
Inglenook  : A space on either side of a large fireplace.
Insouciance  : Casual lack of concern; indifference.
Intrepid  : Fearless; adventurous (often used for rhetorical or humorous effect).
Inure  : Accustom to something, especially something unpleasant.
Invincible  : Too powerful to be defeated or overcome.
Iridescent  : Showing luminous colors that seem to change when seen from different angles.
Jaunty  : Having or expressing a lively, cheerful, and self-confident manner.
Jocular  : Fond of or characterized by joking; humorous or playful.
Jovial  : Cheerful and friendly.
Joyous  : Feeling,showing,or causing joy; joyful
Jubilant  : Feeling or expressing great happiness and triumph.
Judicious  : Having or showing good judgment or sense.
Juvenescent  : Becoming young or youthful.
Kindred  : Ones family and relations.
Kindliness  : The quality of being kind, warmhearted, or gentle; kindness.
Kissable  : Capable of being kissed; inviting to be kissed through attractiveness.
Labyrinthine  : A network like a labyrinth; irregular and twisting.
Lagniappe  : Something given as a bonus or extra gift.
Lagoon  : A stretch of salt water separated from the sea by a low sandbank or coral reef.
Languid  : Displaying or having a disinclination for physical exertion or effort; slow and relaxed.
Languor  : The state or feeling, often pleasant, of tiredness or inertia.
Lassitude  : A state of physical or mental weariness; lack of energy.
Leisure  : Free time.
Lilt :  A characteristic rising and falling of the voice when speaking; a pleasant gentle accent.
Lilting  : Speak, sing, or sound with a lilt.
Lissome  : A person or their body that is thin, supple, and graceful.
Lithe  : A persons body that is thin, supple, and graceful.
Lovable  : Inspiring or deserving love or affection.
Lullaby  : A quiet, gentle song sung to send a child to sleep.
Luminescence  : The emission of light by a substance that has not been heated, as in fluorescence and phosphorescence.
Luxury  : Sumptuous or extremely comfortable living surroundings.
Magnificent  : Splendid in appearance;grand.
Marvelous  : Causing great wonder; extraordinary.
Mellifluous  : Sweet or musical; pleasant to hear.
Mellow  : Pleasantly smooth or soft; free from harshness.
Mindfulness  : A mental state achieved by focusing ones awareness on the present moment, while calmly acknowledging and accepting ones feelings, thoughts, and bodily sensations, used as a therapeutic technique.
Minutiae  : Small or trivial details.
Moiety  : Each of two parts into which a thing is or can be divided.
Mondegreen  : A misunderstood or misinterpreted word or phrase resulting from a mishearing of the lyrics of a song.
Murmurous  : Filled with or characterized by murmurs; low and indistinct
Nemesis  : A long-standing rival; an archenemy.
Namaste  : A respectful greeting said when giving a namaskar.
Nebulous  : Unclear, vague, or ill-defined concept or idea.
Nirvana  : A transcendent state in which there is neither suffering, desire, nor sense of self, and the subject is released from the effects of karma and the cycle of death and rebirth. It represents the final goal of Buddhism.
Nourishment  : The food or other substances necessary for growth, health, and good condition.
Nurture  : Care for and encourage the growth or development of.
Oblivion  : The state of being unaware or unconscious of what is happening.
Omnipotent  : Having unlimited power; able to do anything.
Onomatopoeia  : The formation of a word from a sound associated with what is named
Optimistic  : Hopeful and confident about the future.
Opulent  : Ostentatiously rich and luxurious or lavish.
Pacify  : Quell the anger, agitation, or excitement of.
Palimpsest  : A manuscript or piece of writing material on which the original writing has been effaced to make room for later writing but of which traces remain.
Panacea  : A solution or remedy for all difficulties or diseases.
Panoply  : A complete or impressive collection of things.
Paradise  : An ideal or idyllic place or state.
Passion  : Strong and barely controllable emotion.
Pastiche  : An artistic work in a style that imitates that of another work, artist, or period.
Persevering  : Persistent; constant in the execution of a purpose.
Perspicacious  : Clear-sighted; mentally perceptive or acute; keen.
Petrichor  : A pleasant smell that frequently accompanies the first rain after a long period of warm, dry weather.
Phenomenal  : Very remarkable; extraordinary.
Phosphenes  : A ring or spot of light produced by pressure on the eyeball or direct stimulation of the visual system other than by light.
Piquancy  : A pleasantly sharp and appetizing flavor.
Plethora  : A large or excessive amount of something.
Precious  : An object, substance, or resource of great value; not to be wasted or treated carelessly.
Prevarication  : To deviate from the truth
Propinquity  : The state of being close to someone or something; proximity.
Prosperity  : The state of being prosperous.
Pyrrhic  : A victory won at too great a cost to have been worthwhile for the victor.
Quaint  : Attractively unusual or old-fashioned.
Quantum  : A discrete quantity of energy proportional in magnitude to the frequency of the radiation it represents.
Quickening  : To enter into a phase of active growth and development
Quiescent  : In a state or period of inactivity or dormancy.
Quietude  : A state of stillness, calmness, and quiet in a person or place.
Quintessential  : Representing the most perfect or typical example of a quality or class.
Radiant  : Sending out light; shining or glowing brightly.
Rapturous  : Characterized by, feeling, or expressing great pleasure or enthusiasm.
Ratatouille  : A vegetable dish consisting of onions, zucchini, tomatoes, eggplant, and peppers, fried and stewed in oil and sometimes served cold.
Ravel  : Untangle or unravel something.
Ravishing  : Delightful; entrancing.
Redolent  : Strongly reminiscent or suggestive of something.
Rejuvenate  : Make someone or something look or feel younger, fresher, or more lively.
Relent  : Abandon or mitigate a harsh intention or cruel treatment.
Repose  : A state of rest, sleep, or tranquility.
Resilience  : The capacity to recover quickly from difficulties; toughness.
Resplendent  : Attractive and impressive through being richly colorful or sumptuous.
Revelation  : A surprising and previously unknown fact, especially one that is made known in a dramatic way.
Reverence  : Deep respect for someone or something.
Rhapsodic  : Immoderately empassioned or enthusiastic.
Righteousness  : The quality of being morally right or justifiable.
Riparian  : Relating to or situated on the banks of a river.
Ripple  : A small wave or series of waves on the surface of water, especially as caused by an object dropping into it or a slight breeze.
Romance  : A feeling of excitement and mystery associated with love.
Sacred  : Connected with God (or the gods) or dedicated to a religious purpose and so deserving veneration.
Salve  : Something that is soothing or consoling for wounded feelings or an uneasy conscience.
Sapphire  : A transparent precious stone, typically blue, that is a variety of corundum (aluminum oxide).
Savor  : Enjoy or appreciate something pleasant completely, especially by dwelling on it.
Scintilla  : A tiny trace or spark of a specified quality or feeling.
Sempiternal  : Eternal and unchanging; everlasting.
Sequoia  : A redwood tree, especially the California redwood.
Seraglio  : A large harem.
Serendipity  : The occurrence and development of events by chance in a happy or beneficial way.
Serenity  : The state of being calm, peaceful, and untroubled.
Silky  : Of or resembling silk, especially in being soft, fine, and lustrous.
Simplicity  : The quality or condition of being easy to understand or do.
Solitude  : The state or situation of being alone.
Somnambulism  : An abnormal condition of sleep in which motor acts (such as walking) are performed
Sonorous  : Capable of producing a deep or ringing sound.
Soulmate  : A person ideally suited to another as a close friend or romantic partner.
Spacious  : Having ample space.
Spellbound  : Hold the complete attention of someone as though by magic; fascinate.
Spherical  : Shaped like a sphere.
Splendid  : Magnificent; very impressive.
Sprightliness  : Marked by a gay lightness and vivacity.
Statuesque  : An attractively tall and dignified woman.
Sublime  : Of such excellence, grandeur, or beauty as to inspire great admiration or awe.
Succulent  : Tender, juicy, and tasty food.
Summery  : Characteristic of or suitable for summer.
Sumptuous  : Splendid and expensive-looking.
Supine  : Lying face upward.
Surreptitious  : Kept secret, especially because it would not be approved of.
Susquehanna  : A river 444 miles (714 kilometers) long in the eastern U.S. flowing from central New York south through Pennsylvania and into the Chesapeake Bay in northern Maryland
Susurrous  : Full of whispering sounds.
Symphony  : Something regarded, typically favorably, as a composition of different elements.
Talisman  : An object, typically an inscribed ring or stone, that is thought to have magic powers and to bring good luck.
Tenacity  : The quality or fact of being able to grip something firmly; grip.
Tender  : Showing gentleness and concern or sympathy.
Tintinnabulation  : A ringing or tinkling sound.
Tolerance  : The ability or willingness to tolerate something, in particular, the existence of opinions or behavior that one does not necessarily agree with.
Tranquility  : The quality or state of being tranquil; calm.
Transfiguration  : A complete change of form or appearance into a more beautiful or spiritual state.
Triumph  : A great victory or achievement.
Umbrella  : A device consisting of a circular canopy of cloth on a folding metal frame supported by a central rod, used as protection against rain or sometimes sun.
Unabashed  : Not embarrassed, disconcerted, or ashamed.
Unflappable  : Having or showing calmness in a crisis.
Unification  : The process of being united or made into a whole.
Unique  : Being the only one of its kind; unlike anything else.
Varnish  : Resin dissolved in a liquid for applying on wood, metal, or other materials to form a hard, clear, shiny surface when dry.
Veneration  : Great respect; reverence.
Verity  : A true principle or belief, especially one of fundamental importance.
Vestigial  : Forming a very small remnant of something that was once much larger or more noticeable.
Vibrant  : Full of energy and enthusiasm.
Victorious  : Having won a victory; triumphant.
Virtuous  : Having or showing high moral standards.
Vitality  : The state of being strong and active; energy.
Vitriolic  : Filled with bitter criticism or malice.
Vortex  : A mass of whirling fluid or air, especially a whirlpool or whirlwind
Vulnerable  : Susceptible to physical or emotional attack or harm.
Waft  : Pass or cause to pass easily or gently through or as if through the air.
Wanderlust  : A strong desire to travel.
Warmhearted  : A person or their actions that are sympathetic and kind.
Wherewithal  : The money or other means needed for a particular purpose.
Wholesome  : Conducive to or suggestive of good health and physical well-being.
Wondrous  : Inspiring a feeling of wonder or delight; marvelous.
Worship  : The feeling or expression of reverence and adoration for a deity.
Xanadu  : An idealized place of great or idyllic magnificence and beauty.
Xenophobia  : Dislike of or prejudice against people from other countries.
Xylophone  : A musical instrument played by striking a row of wooden bars of graduated length with one or more small wooden or plastic mallets.
Yearling  : An animal (especially a sheep, calf, or foal) that is a year old or that is in its second year.
Yearn  : Have an intense feeling of longing for something, typically something that one has lost or been separated from.
Yesteryear  : Last year or the recent past, especially as nostalgically recalled.
Zealous  : Having or showing zeal.
Zenith  : The time at which something is most powerful or successful.
Zephyr  : A soft gentle breeze.
Zestful  : Characterized by great enthusiasm and energy.
Zinfandel  : A variety of wine grape grown in California.
Zither  : A musical instrument consisting of a flat wooden soundbox with numerous strings stretched across it placed horizontally and played with the fingers and a plectrum. It is used especially in central European folk music.
Zoophilic  : Having an attraction to or preference for animals.
Amorphous  : Without a clearly defined shape or form.
Atrament  : A very dark substance, usually liquid.
Caliginous  : Misty, dark, obscure.
Cimmerian  : A member of a mythical people living in perpetual mist and darkness near the land of the dead.
Crepuscule  : Twilight. Obscure, doubtful, or uncertain.
Darkling  : Growing dark or characterized by darkness.
Dystopian  : Relating to an imagined state or society where there is great suffering or injustice.
Eigengrau  : The dark grey color that human eyes see in perfect darkness.
Gloaming  : Twilight, dusk.
Nebulochaotic  : A state of being hazy and confused.
Nefarious  : Wicked or criminal.
Nyctophilia  : An attraction to darkness or night; finding relaxation or comfort in the darkness.
Pernicious  : Having a harmful effect, especially in a gradual or subtle way.
Photophobic  : Having an extreme sensitivity to light; growing best under reduced illumination.
Somber  : Gloomy, sullen, melancholy; solemn in mood.
Stygian  : Extremely dark, gloomy, or forbidding.
Tenebrous  : Dark, shadowy, or obscure.
Umbra  : Shadow or darkness. A shaded area.
Woebegone  : Sad or miserable in appearance